####################################################################
###########     #######       $     ###########   #######    #######
#######       $     ##########   ###############           ##   #####
###  ######        #######   # #         #########   $    ###     ###
#######       #############      #######    ####### ####    #########
#########         #######    $   ######### ####     ######   ####  E#
###   ##     #########      #######    $        ####   ###        ###
#####    $    #######   ###   ########  ## #################    #####
##  ####    ##############     ##########   #########  ######   #####
#########   ##                ##########     #######  ####### ## ####
#####  ###     ###########    ###########  ##########     $    ######
##   $ ### ###########       #############     $  #######   ##   ####
######    ######S        ###########         ###########    ###    ##
####### #############  ############  #######     ###########   ######
#######                ###########   #######   #############  ########
####################################################################
