#####################################################################
#####################################################################
##     #   #      $  #         # $       $               #         ##
## ### # # # ####### # # ##### ######### ############### ##### ### ##
##   #   # #   #   #   #   # #  S      #     $   #     #     #   # ##
#### ##### # ### # ####### # ######### # ####### # # ####### ##### ##
##   #   # # #   #       # #   $ #     #   # #   # #       # #   # ##
## ### # ### # ######### # # # ### ####### # # ##### ##### # # # # ##
## #   # #   # #$#         # # #   # #       #     # # #   #   # # ##
## # ### # ### # # ######### # # ### # ##### ##### # # # ####### # ##
## # # $ #   # #     #   #   #     #   #   #   #   # # # #     #   ##
## # # #####$# ####### # ######### ##### # ##### ### # # # ### ### ##
##   #      $#         #       #  E      #       # $   #     #     ##
#####################################################################
#####################################################################