####################################################################
#########################   ####             ############### #######
########              ##          $           ########          # ##
###   $    #####     # ###  ###  ###  ############ ####    $      ##
#####       ####    ## #########        ########    ######  ####   E
##########         $        #######   #######                   # ##
#######  ##     #####    #####      #####     $    #########    ####
##          ############        ###########         #   #####   ####
##S ####         ########       ##################      #####      #
##          ###    #######     $    ################    ##  #####  #
####################        ###########         ######      ########
#######################             ##########      #####       ####
###########      $      ########        ########    ########    ####
####################################              $               ##
####################################################################